NO textures/bricks.xpm
SO textures/ice.xpm
WE textures/lava.xpm
EA textures/leaves.xpm

F 164,169,20
C 153,204,255

111111111
11001111111
100000N11
111111111