NO textures/bricks.xpm
SO textures/ice.xpm
WE textures/lava.xpm
EA textures/leaves.xpm

F 18,53,25
C 153,204,255

111111111111
1         11
1       0001
1000000 0011
11100S000001
  111111111111
  11         1
11111111111111