NO textures/tech_1.xpm
SO textures/tech_2.xpm
WE textures/tech_3.xpm
EA textures/tech_4.xpm

F 101,183,65
C 123,211,234

111111111111111
100000100000001
101111101000001
100000S01000001
100100000000001
100111010000001
100001010000001
100111010000001
100000000000001
111111111111111