NO textures/tech_1.xpm
SO textures/tech_2.xpm
WE textures/tech_3.xpm
EA textures/tech_4.xpm

F 101,183,65
C 123,211,234

111111111111111111111111111111111111111111111111111111111111
100000010000000000000000100001100000000000000000000000000001
100000010000000000000000100000000000000000000000000000000001
100000010000000000000000000001100000000000000000000000000001
100000000000000000000000100001100000000000000000000000000001
100000010000000000000000100001100000000000000000000000000001
100000011111111111111111100001100000000000000000000000000001
100000000000000000000000000001100000000000011110000000000001
100000000000000000000000000001100000000000000000000000000001
1000000000N0000000000000000001100000000000000000000000000001
100000000000000000000000000001100000000000000000010000000001
100000000000000000000000000000000000000000000000010000000001
100000000000000000000000000001100000000000000000010000000001
100000000000000000000000000001100000000000000111111000000001
1000000000000000000000000000011000000000000001    1000000001
1000000000000000000000000000011000000000000001    1000000001
1000000000000000000000000000011000000000000001    1000000001
100000000000000000000000000001100000000000000111111000000001
100000000000000000000000000001100000000000000000000000111001
100000000000000000000000000001100000000000000000000000001001
100000000000000000000000000001100000000000000000000000001001
100000000000000000000110000001100000000000000000010000001001
100000000000000000000000000001100000000000000000010000001001
100000000000000000000000000001100000000000000000010011111001
100000000000000000000000000001100000000000000000010010000001
100000011111110000000000000001100000000000000000011110001111
100000000000000000000000000001100000000000000000000000111
10000000000000000000000000000110000000000000000000111111
100000000000000000000000000001100000000000000000011
10000000000000000000000000000110000000000000000001
11111111111111111111111111111111111111111111111111