NO textures/tech_1.xpm
SO textures/tech_2.xpm
WE textures/tech_3.xpm
EA textures/tech_4.xpm

F 101,183,65
C 123,211,234

111111111111111111111111111111
100000010000000000000000100001
100000010000000000000000100001
100000010000000000000000000001
100000000000000000000000100001
100000010000000000000000100001
100000011111111111111111100001
100000000000000000000000000001
100000000000000000000000000001
1000000000N0000000000000000001
100000000000000000000000000001
100000000000000000000000000001
100000000000000000000000000001
100000000000000000000000000001
111111111111111111111111111111
