NO textures/tech_1.xpm
SO textures/tech_2.xpm
WE textures/tech_3.xpm
EA textures/tech_4.xpm

F 101,183,65
C 123,211,234

1111111111
1000001001
1011111011
100000S011
1001000001
1001110101
1000010101
1001110101
1000000001
1111111111